CartId,ProdCount,ItemCount,TotalPrice,Discount,NetPrice
121,2,5,110,15,95
122,3,10,88,6,82
123,1,1,5,0,5
124,4,7,30,2,28
125,2,6,62,11,51
126,3,3,18,2,16
127,1,5,22,4,18
128,4,6,42,5,37
129,2,4,33,6,27
130,3,11,29,8,21
131,1,2,8,1,7
132,4,4,38,4,34
133,2,12,12,1,11
134,3,9,27,3,24
135,5,8,128,15,113
136,6,7,41,5,36
137,2,2,8,0,8
138,3,3,9,0,9
139,5,6,6,0,6
140,4,18,47,3,44
141,2,11,75,8,67
142,3,3,12,1,11
143,5,8,16,0,16
144,6,25,33,1,32